11
111111111111111
111111111111111
111111111111111
111111111111111
111111111111111
111111111111111
111111111111111
111111111111111
111111111111111
111111111111111
111111111111111
111111111111111
111111111111111
111111111111111
111111111111111
111111111111111
111111111111111
111111111111111
111111111111111
111111111111111

11

;
000000000000000
000000000000000
000000000000000
000000000000000
000000000000000
000000000000000
000000000000000
111111100000000
000000100000000
000000100000000
000000100000000
000000100000000
000000100000000
000000100000000
000011100000000
111110000000000
000000000000000
000000000000000
000000000000000
000000000000000
1111