11
111111111111111
111111111111111
111111111111111
111111111111111
111111111111111
111111111111111
111111111111111
111111111111111
000000111111111
000000111111111
000000111111111
000000111111111
000000111111111
000000111111111
000001111111111
111111111111111
111111111111111
111111111111111
111111111111111
111111111111111

11

;
000000000000000
000000000000000
000000000000000
000000000000000
000000000000000
000000000000000
000000000000000
111111100000000
100000000
100000000
100000000
100000000
100000000
100000000
1100000000
111110000000000
000000000000000
000000000000000
000000000000000
000000000000000
11111