11
111111111111111
111111111111111
111111111111111
111111111111111
111111111111111
111111111111111
111111111111111
111111111111111
111111111111111
111111111111111
111111111111111
111111111111111
111111111111111
111111111111111
111111111111111
111111111111111
111111111111111
111111111111111
111111111111111
111111111111111

11

;
000000000110000
000000000010000
000000000000000
000000000000000
000000000000000
000000000000000
000000000000000
000000000000011
000000000000110
000100000001100
000100000111000
000100000000000
000100000000000
000000000000000
000000000000000
000000010000000
000000010000000
000000010000000
000000000000000
000000000000000
1111