11
111111111111111
111111111111111
111111111111111
111111111111111
111111111111111
111111111111111
111111111111111
111111111111111
111111111111111
111111111111111
111111111111111
111111111111111
111111111111111
111111111111111
111111111111111
111111111111111
111111111111111
111111111111111
111111111111111
111111111111111

11

;
000000000000000
000000000000000
000000010000000
000000000000000
000000000001110
010000000000000
000000000000000
000000000000000
000001110000000
000000000000000
000000000010000
000000000000000
000000000000000
111111000000000
000000000001110
000000000000000
000000000000000
000000010000000
000000000000000
000000000000000
1111